58 58 58 58 58 58 58 58 58 58 58 58 58 58 58 58 58 58
58 24 24 24 24 24 24 24 24 24 24 16 58 22 22 22 22 58
58 24 27 24 24 31 24 24 24 27 24 24 58 22 22 22 22 58
67 24 24 24 24 24 24 28 24 24 24 24 67 22 22 22 22 68
67 24 24 32 33 24 24 24 24 27 24 28 66 22 22 22 22 68
58 24 24 24 24 30 24 24 24 24 24 24 58 22 22 22 22 69
58 24 27 24 24 24 24 31 24 24 23 24 58 58 58 58 58 58
60 58 58 68 60 63 21 58 69 61 58 62 58 35 35 35 35 58
58 24 24 24 24 24 24 24 24 24 24 24 58 24 24 24 24 58
58 24 31 24 27 24 24 28 24 24 28 24 58 24 32 33 24 58
58 24 24 24 28 24 24 24 24 24 27 24 35 24 24 24 24 68
58 24 31 24 27 24 24 22 24 27 24 24 58 24 24 24 24 58
40 24 24 24 24 31 24 24 24 28 28 24 20 24 24 24 24 58
58 24 24 24 24 24 22 24 31 24 24 24 58 24 24 24 24 58
58 31 31 24 31 31 27 28 24 31 24 22 58 24 24 24 24 58
58 24 24 24 24 24 24 28 24 24 31 27 58 24 24 24 24 58
58 49 39 43 46 46 20 43 43 38 32 33 58 46 46 46 46 58